17
105 13 0 64 28 0 0 1
0.008
*****11111
00000****1
111010000*
100100111*
100001000*
111110001*
000000110*
111111000*
110000111*
111111000*
<3333433345555555>
