18
81 10 0 52 19 0 0 1
0.011
**0111100000110
10**01001110001
0000*1001101000
10000*000101001
100100*01101000
111100*01101001
1000000**101000
101111000*01001
0011000001*1001
11100111101*000
100010000011*00
1000010011001*0
1111100011000*0
10011001010110*
01100010111111*
<34344454344444545>
