58
665 84 0 415 166 1 0 1
0.022
*001*1100000110
*00*0*0011*0001
0*0*0*001*0*000
*00*0*000*0*001
*00*0*001*0*000
1**10*00*10*001
10000*000*0*000
1011*1001*0*001
00**0000*10*001
1*100***100*000
*000*000000*000
*0000*0011*1111
1**1*0001*00000
100*10010*01111
0110001011*****
<546543211124555556676654342282332218211245555555566543333>
