125
14185 1967 0 5975 6243 194 0 3
0.542
*100100101111100001010100010111111010111001001110101111100000000010101000111111010011111100110111000
1*10110100110111001110010010001100100000111111001110101100011101010101111010101110111001111110001110
1*01011100101100010110001111100010111010111101101001100111101110100110101111110110101110110101101110
01*1011011111001111011110010101111100001000001010011100110101101010100111111101111011111110000011000
00*0011100101001111101011011011001001011100101111010111111111111101110101100111011011110010010110111
011**11001111001000111001000101110001111101101111111100010011011111101101011111110101010010010111110
10110*1111101111101011111101010011111111110001010011101111111001011001111111110001100100100101111101
100101*010010111101110101101111010111100111010111111001110001010010110111000101101010011001111101001
01010*0010100100011110011001100100111110000011101011101111101100001000010100111010000101011111010111
100101**10001110010101101110011011101101110011111100111110011011100101111110010110101100010001011111
00001100*0100111111001110011000010111100111011110101111110111000101111101110111011101001111000101110
101111100*110000110111000110111111011011101011111011110111111001111011110100011011001101000001011110
1100110101*10101001100111111000111110001111111001110101001100010100101101100001101010011011111110101
10011010100*1101110000101000110110011000101001111001110101110111001011101110010011011100011110001001
100111001111**10111011010100100011010111100011111001101011010110011010001011101100101011101101111101
00111010011110*1101011100111110101100111111011101110111011001110110000100111100010011010101111001000
110111100110110*100101101100011010000111000011010000011111111001000111111101111101001100000101110010
1111100111011100*11111100111101101011011110000110100011101100101101110100110001110100111100101111011
01010111011011100*1010001101011101001010011001110100101111110010110000111111110101011100001011011001
001100111110110011*111111101010110101101110100100100000011111000111111101110111010100101101101100111
1001001001101011011**0101011110000100111000111111011110111101111110010001100100110111101111000101111
001010111111100011000*111110100010111001010101000111001110011100010111101111101010110110001111110110
1111111001111000111001*00011101001110111111010111101010111110111001010101111110010111110111111101010
10110101110101111001010*1*10011001011100101110111111010011011100110110101101010100111011100111010111
010001100001000011110001*0*1001010100110011110000101101010011111000001001100001001010111100111111100
11110011110111111111011110*1010111100111001111011110011110110110111101111111111010011110100011111110
11001000110100101110111110*1111100110110100110011011101111010011111001101001001011010010100000011010
001010110010111111011111001*101110110011111111110001010010011010111110000100110100100101000010000111
010010010111000001011101000*000010011111011110101000000111100100101101011001100111111111110111000011
101111110011001111110010011*0*0000100101110111010011000000011110010111011110001110001110101101101011
1111111001000101010111110111*0**10011001101011101100100011111111000111111101011010100001010110011010
01110111111001000101011000010000*0100001101111010111010010000100011110111000110010011111110011100110
00000010111010101101110110111101*0101011011100110010000100011000111001011111011110110111111110110000
00110011110011101101111010011000*0100101001111111011101011110100100011111111101110101001001101000101
000111111010111100011010011111101*111101100111011110101000110100101100111101001111111100001110101111
1101101110111111100110101011010010*01100111101100101000010010011111010110111111001110111100011111011
00111101011111111011110001101110011*1010011110001010011110011100100100100101101101110111111010101010
10110110100001110110111010011111101*0000110000111010111111111011100110111111101111000100011011101101
01011101001000011111110011111000100*0011101001101000110001101011111111101111111111011100101000001001
11011100100111101111100010101100110*0*00110101111100010110001011110111111111001010010111010110111110
001110011010010101101011001111111001*0*1000010110010110100111100000100110110101110011111101111001000
011011111110001100110011101000000011101*111101100110101100001111010000100101100111001110001110111111
0111010111100111010011011111110100100001*00001111101010001100011001110101101011101010011110101010110
1101111101110111111111111010000110000001*01011011011011010101101111110111100111111000101011100000001
10110001110100011100010111011110011001001*0111111001111110110001111100010111010111001011001101010001
01011010110000011110010111001100101001001*0001111100111100101011010111101001110101000111110101111011
111101111011100110010111011111000111110101*000001111011111011100110101111101100100110010001101111011
1101000101001111100111111011111101011101110*00110111011101110011111011000011111010010011101011011110
11010110100111101001111000011000001001101001*1101110111110010100011100110111011011101011111111111010
10110011101101100111010110110000101101100111*0011011111111011101110011111111101001001000011000101011
101010100011110010010000001110100110111110011**00111110100011100011011101110011101111100111011011001
00101111010111110011101101101110011100110010000*1101010010010110000011000110110011110100100110011110
111100010000000011111011101100111010110101000110*101001111111011110001000011111110111001110011111110
1101111111100110101000110001010110111100111011010*00011111010110001111011101111110111101110001011111
10101110110011000111110011001101100000101001010110*1110111110010100010011101100011010010011010111001
101101010101110101010110001011011111011110100001100*110011011100010101101011110010110011001010100011
1010111000111100100011000111110101110001001010001100*01011010111011100101110101100101111110010100100
1011111100111100011101110110101010010011010110011011*00100111100010001000111000111110000101110111011
01000100110111010010101011111101010111100111111011011*1101100110111101111111110111111100000111101100
011111111110111111101000110101111000000001111011111110*100100100110010110111010011111110011010110110
1010010100100101100100111111101011111110011010110011011*01110001111101111011010101011011111011111111
1111110111100110010101110101000110100001011100111101010*00110001010110110111110001110011010100111111
00010010011110100101000100100110110100001101010100000110*1000010100100000001001110001010001011111001
010010101001000010111010110111000100110110111101011001110*001100010101111111111011110101101110011100
1000010011111110010000001010110100110010111010011111101100*00111110001101001010001101110111010010100
0111000010101101110111000110011111101110101110011011001010*00*10010111101110000111111101111111011100
00001000011001010111111111011100010010000010010011111110101**0*1110100001011110111100111110010011010
101110110100011100011111000110111111110011001111000110111001101**11101000010111100011100101110011011
11000111101011101111011101011110011110001100101100100001011100110*1011011101011111011111001111110010
101100111000110000111000110111101110010111011101111000111000010110*100100001110100011011011110011000
1111111101111100110010011001100101000111001011100110011000100111110*11000100101101001101110001011100
10111001101100111110011111101011111100111110101111000111111100110010*0011001001111101101111110111110
010110101011111001011110111101100010100111110110100000100101010111110*100111000001101111101110011010
1111011111010001110101000000101101100111001100000111100101001011110010*11010000110110011110110101101
1111111011011001111111000010101111011111101010111000011111011011011011*01101011000110111011011000100
11111111110011110011011000110011111101001001011110001111010100101001110*0001110111101110101010010000
111101100010111101100100111110011101001100010101101010011011111010111001**11111111111010111111101111
11000000101111000000101011110101101111110111001100001110111011110110101110*0111111011001110011010010
010010101101111111111001111001110001110011011111111100100111110111010100111*011010111001100011101010
101011001100010001111111010111011000000011100111011011110010111111111011100*010101101000011010000010
111111111111011110001110101000100100101001000100111111001010110111111011110*010111111001000001110110
0110110001011110101001011111011111010111101111101001010100111001011111000001*10011011111110001011110
01111101110011011101111111111010000111010111010101101011111111010000111110100*1110011011010110111111
001001001010111010010011111010011011001000101110010100100011100010111001101100*111000010100100101111
1011110110010101110100001101111000101011101000111111010111111110011011011111111*11101101011000010011
11010010011011110000011011110101011100110111111101111000001100110010110111110111*0011111100110101011
000100101000111100100110111111010110001111011010011000110000000111010011111001100**11001011001011010
01011111110101101011110010111000111011111111110010011011110101111110111010011001000*1110101100111110
001101100111011000111011100101001100100110101101010111111101000001011001001011100100**11000111101111
01110100010111011011101110001111111111001111101100101011001001101101101111001101111110*0110011011000
101001111011110110111010110001010111100001101011111110110001001110010111011010011100100*011110111000
1011010110001111110011000101111111101111100101011000101110111111111111111000000111000010*11000010010
0100101111111101110101100111000101110101111100111010101000111000100001101110011110111110*01010111011
00100000110000000110010110111111101011001111011100111001000110011000011111110010100111011*0110011010
001100100111010111110011111001100000011101101111010100110000111111110101100110000110011001*110111000
11111011110110111101111100111011111001111011010110110101000001000001000111011010100001111*0000011010
010110111111011111110101100110101101111000111111001100111111111110110010111111101110011111*011010111
1010001000010010011110100111110011011110101111010101011110100011101111010001101101001100111**1101110
111011011011010100111101111011111011101101010011000100110100111110010111011110111010100010000*00*000
1110011110111111110101010011001000011111011110110110111011010001001000010010010110110101100111**0***
<4545434464344444344444434444245545542434554445554244454544454344444454445444543244344444454434455444444344344454464434432433>
