50
1161 164 0 697 300 19 0 3
0.074
***1111111111111111111111111111111111111
000*000000000000000000000000000000000001
1010*11111111111111111111111111111111101
010*000000000000000000000000000000000011
0000*01110001111111111111110011111000001
00100*0011111111111111111111111111111111
100100*000000000111110000001111110000001
1000100*00111111111111111111111111111111
01000100*0000000000000000000000000000001
111000100*001111111111111111111111111111
1001000100*00000010000000000000000000001
01001000100*0000001000000000000000000001
000001000110*111111111111111111111111101
0010001000100*00000010000000000000000001
00010001000000*0111111111111111111111111
100010001001**01011111111111111111111101
00000100010*0010100000010000000000000001
0100001000*00001110000111111111111111001
00100001000*0000001000000100001000000001
000100001000*010000100000010000000010001
0100100001000*01100010000001000100001001
00100100000000*0110001000000000010000101
000100100010000*011000100000110001000011
1111100100010000*01100000000001000100001
00000100000010010*0110001000000000010001
011111111100010000*011000100000100001001
0000000001000010100*01100010000010000101
11111111111110000110*0110001000001100001
010010001001000100010*010000100000010001
0010010001001000100010*01000010000000001
11111111111111110000000*0100001000000001
000010010001000001000100*010000100000001
0111111111111111101000100*01000010000001
00000100010010010001000100*0100001000001
111111111111111110001000100*000000100001
0000000100010010010001000100*10010010001
11111111111111111100000000100*1001001001
000000000100100010100010000100*0**000101
1111111111111111111111010000100*00*00011
00001111111111111100001111110000000*****
<3344644444444444676644444444444444444444423443333>
