0
*1001111
1*111111
01*00111
11001011
11100011
00000011
11111111
11000111
11110010
11111001
