0
*0000000000000000000
1*000000000000000000
10*11111111111111100
101*1111111111111100
1011*111111111111100
10111*11111111111100
101111*1111111111100
1011111*111111111100
10111111*11111111100
101111111*1111111100
1011111111*111111100
10111111111*11111100
101111111111*1111100
1011111111111*111100
10111111111111*11100
101111111111111*1100
1011111111111111*100
10111111111111111*00
10000000000000000000
11111111111111111111
