26
*111111111111111111111111
0*10000000000100000000001
01*1111111111111111111101
001*111111111111111111101
0011*11111111111111111101
00111*1111111111111111101
001111*111111111111111101
0011111*11111111111111101
00111111*1111111111111101
001111111*111111111111101
0011111111*11111111111101
00111111111*1111111111101
001111111111*111111111101
0011111111111*11111111101
00111111111111*1111111101
001111111111111*111111101
0011111111111111*11111101
00111111111111111*1111101
001111111111111111*111101
0011111111111111111*11101
00111111111111111111*1101
001111111111111111111*101
0011111111111111111111*01
0000000000001000000000*01
00000000000011111111111**
