0
*1011111111111010101111011110110110101110111111111
1*111010110011111111111111111100111110110100111111
11*11101111001101111101111110110101110111111011100
011*1100111110011111011011111010111110111010110100
011*0111101111111111100011111011111111001110111100
1111*111011110100111011111111110111110010110110011
10111*11011010111100110111011011111111010111111100
011101*1011011111111111111111110001111111011101011
1110100*111011111111111000111101110111010111101111
0111111*011011111011111111000111111101110111010111
10101110011000101101111111111111001100010100111010
11111111011011101111010011111110011010101110111010
11110111011111101111100111111111011101111111111011
11101110111001101111110111111111101100101011111111
01111011010111101111110111010000000000000111111010
01010011111111101111111111010111011111101111110111
01010111011111100111011110111011011011111111111111
01101001101111001111111111101111110111101111110110
11101110001011111011111111100111110100100111101110
11111110111101111110100111111111111111100110110111
11110111101101111011111100111111110111111000111101
11101001110110101110011111111111101011111111111011
11011111101011111011111111111110110101111001111111
11111110011111101111111111110111011010111111111101
11111111111111010011111111111011111011100111111111
01111110110101111100101111011111111111011111001111
01111111111110111110111111111111110111111111001011
11110001111101111111101011101111111111111111010110
10110111001111111111001010111111011111011100111101
11111100111111111001101100011110000111100001111101
