0
*101000011010010011111001111101101000111011111111101101010100001110110111001110111110111101001111011
1*11111101110001111111101100110111111101011110111011100111110011111101111101100111101101110100100111
11*1111111001011101111111010011010101011101100101001110010100111111011100000101001001101011000011111
011*111001111111011101000001101011101100011110010001101111010111011001110111111001111001100111001111
011*011101110111000011101111111010111101111111011010110110110000101110100011011010100100100110011111
0111*11111111001111110111101010110111100111010100011101010111111110110011111111101010111111111111101
01111*1111101111000111001011011111010101011111111010111111010100011111111110101101011001010111101001
111101*111101001100111001101101111111101011111011111111110001111111010110011011110010111111111010011
1101101*11011111111111110111110111011101111101111111111111111000111110111101111110111010000111101011
11111111*1111111110011011001011011111100111110010000101010110110010111111000111100011010101011010101
100111101*111100010101111111011111001111111110111110111110001100101100111001111101110000110100111110
0111001111*11011101110101101101111111101100110110111111110110111111010011100101111111001111111011100
01110111011*1111110100111011110001110111011101001101111011111111111011100101110111101100011100110001
11110111110*0111111111111101111110011101001111111111111111101110110111110101011001110110111100111111
101111111111*111111110111001101001111100110011111100111111101011001011111111111110011011101101111101
1111111111111*10101110101101010110110111011111111001001010111101110110110111111010000101110110000111
11001101011110*1011111111111101100111111111111111111011011110100000011101100111011001010111100010101
11110100101111*0011111101011111111001011101111011111110111000011110111111100111110111110110011101011
101111111110011*101111110010110001111111100110110100011111000101111011111111011111111101111111010100
1111111110011111*11111111111111010010111100001001011110101111011111011101111111100111100101100111100
00101011011101011*1110101101111111101110101110011010110000111101000001111111111101110101000101101111
111101100100111111*011011111111110101111111011100111111111000101111010011111111111110111100010111001
0101111111011111111*01111110101110011111011110101111110101101111111101101001111100100101001100011011
1111111111111110111*00011111111111110100101111111010011010011011111011111011011010011110011110111110
11101011000011111111*1110111111111110110111111111100111100001101111111100101011110001110111111110110
11100010111011101101*0111001111110111111001000101111100100110111011000110111101011011111111001001011
110101111111100111011*101111111101011101111111110101100111111110000110011011111111110101110001000111
1111110100111101111011*10100110010011111011111111111111111010110111111010101110011001010001010001111
11011011011001101111011*1011011111101011101010110101110111000111011110100101010101010001100101110011
100011101110011111101110*111101111111111101100011001111101001111111100111110011001111101111110110111
1111011010111001110110011*00101100111110110101101011010111011000111011110000111111111000110001001001
01011011010110101111110111*1011011110111111011000110011010111010110010101001110011110111110011010111
110101111110110101110111111*111011011111111111010010111110011110011110111101111001110111110111011111
1101111011011000011110101111*11111110110110111110111111111011111111111101111011010011110001101110111
11101010110111000100101111100*1111110011011111100011111110000111111110110101011011101111111111101110
011111111111100011101001111110*010111011101101110111001111010111011101111110001101011110111100101111
1110111101011111111011100011111*11111101111001011001001101011100001111011110011010001011110110011010
10100100111110100110101111011001*0111111011111010101110011001111101001110001111001111010100011111011
011110111111111100011110011100010*111111111110111110010001110011111010111001011110111111000111101010
011111011110111000001111000111111*001111111111001011101100001111000010011100010110100010110011110111
0000111101111101110100001001011110011110011011001011111111110111111101010111101110000101111011111110
0100110011010101110000101111010111111011110111101111011110111111110110011111101101110111110111101111
1001011000011111010111111111111101111011111111100100000111011001111111011001111111110101010111110010
0111001110111110010011100011111110110011111111111101000111111111111110110001011111111011101110101101
1110110011011111101111110100011111111111110011011011111110111111111110111100001101011111001111110110
0111111111010101111111011001111111011101100011111001111101011100110011111011011111010011010011000111
1011111100110011101011001110101101111111111001111111100010110011110111100101111101111000110000110010
0101111101111011011111111000101011011111000111111111110101111001110101101010110011011101111101101111
1111100001011111110001101110101111011101111101101110111111111111100111111100111111010011111100100010
1101111101011111110111111111111111101100011101111111111111100101111111011111101110101010111101110100
0011101010111000010100101010101011111101111111101101110011111100110111100111011100111110111110111111
0110100010010100011111111010001111111111110100001110111111101111111001111011101111101001100011110001
0110111001110111111111111110111010011111111110111011100110111110101011110110111111101111111011011110
1111111001110010111111100101011101111101110101111110101111110111011010110010111010111110100001100101
0111001010111001101101101100111111111111111111110101011111111011100000111110101110010110101001111110
0010011001101101101101111110101101111100111100101011111011101011111111001011111001101010010111111111
1011111101110010111110101110101111001110011101111011110101110111111101110110111110111110000010111011
1001011111010110101011100111001101001111111111111110100111010101101110011011100110110010101110001001
1110101111111111111001101011010101110101111101101011001100100111111111111111111011010001111111110100
1010010100111111110111101010000111011101101110111011111111001011011111111111101100010001010100111101
0011011111111111110101101111101011100111011111010000000110111100111101001111101110001000110011001111
1000101111101011100110110011111010001011111011111111111001110000111101001111111111011111111101101101
1111101111111011111111111110011111110110111110011110111110111101011101111111100111101110100111101111
0110101101111111110000111011111001101111010111110110101011111111110111101111110111110110111011101101
1110101111111111001110011111010011000001110110111101101011111011010011110111111111101001010011011111
1101111010111100111110110100110101110110101101100111111001110101011001111011111110111011101011000011
0111010111101110011100011011011011000100111011111111111111110110011111110101110101010111100100010001
0011100111101011100000111111101111111110111101001101011111110110000110011101110001111101010110111111
1111011110111110011111110011110011101100011011011011111110111001001111011111111001101110111010111111
0110001110011111110101100001011000110111111100011111011111101110111111111111111110101111101011100001
0111111011101111111100111110111110011011100001001101110111111111011101101110011110011010111101010111
1111011100111011111111101011011101010100010111011000111111110110010111101001111111111111100111011110
1000011011011011010111101100000101011011100011000111111111111100111011011001001101111011011001110101
1010011111101110110011111111110101101001111111111110011110011101011111010111110111110101101001011011
0101111111111111111001100100010011001101111101101001101011011111110111111011111101111101111111111111
1011001111111011111011001011111111111011101000111101110111111100100111111001011001111111011111011001
1111011100111111011101111110111001010101100100001100010100010111111110111111111011011111111111110100
0111110110111110100111110110001111101011011011011110111110111011110110111111111110101100110011110111
1111101000101111101101111011111010111010111111011111101111100011001110101111101111011111011111111111
1111110011100111011111111111110010111100110111101111111111011011111111111111001111110111100011011111
1101110111110111111101110100111001111000101111111000100011111111111001001000111111111110111111111101
0010000111101011010111101001101111111110111111011110111001100011101111111101011111101101111000101101
0111001111011000100110000011111010111000011000111101101010011011101111111111111111111111111111111111
0100111011110101110111111110111100111101000111101110111111011011101111111101101011111111101111101101
0111111100000111001111011111011111011111011111111111100101101111000111101110110101111011111111111001
1010110101010100011111111111011101001110111111011010101100011111110110000110111101111111001111101011
1001010101010111000101011101000110111011011011101111000010111111110100000111011011101111101111111101
1101011111101111001110001000011100011110111100011111110110111111011111010011001011111011011111101111
1100111100111111011111011100001111111111011111001111100111111011111010110111111011101011011101111111
1101101101111110011011011000001101101011001101001111011101100110111100110111110100001111110110011111
1111101100111011111111101011111010010110111101111110100110010011101101111111111001110100110101101111
1111111111001100111011100111111011011101011011001011001111111111011111110011101110111001001010010111
1110101111101101100111101011100101011100110100010001111111111101011001011011111101100110111100011101
1101111011001011000111110111111111111111110101101111110001110101011001110101010110111010111111011111
1110000111110011000101101011011111110110110111000011100110000110111111001111110001110101110111100101
0111111011111111111111100110111101111111011111111101010111111110111110110111001101110111010110111101
1111001100101111110111110100111100100110001111111001101111001110010001111100010011101110110001111111
0011101000111111101011111000011101111111001101111101110011101110101100111111011111001011111100110111
1100111011111101011100101101001111011110011111101011010110111010110010111110111110110111111011101111
1011011111101011111111110110111111010111111101011110111100111000101111010111111011110111010111111111
