27
809 106 5 552 151 
0.013
**00111101
00*0000101
00*010*101
00*01*0*01
00*0*00*01
000*000*01
01000*0*01
1010*0*101
100*100001
11*0100*01
00*000*0*0
000***000*
<34555422245556866654332244>
