29
2521 327 12 1712 482 
0.023
*****11111
00000*1111
1**0*00000
*00*00***0
*0000*000*
1****000*0
000000**00
11111*0001
110000***0
111111000*
<3333466876543332233466764334>
