17
177 23 1 102 52 
0.039
********11
00000111*1
111010000*
100100111*
100001000*
111110001*
000000110*
111111000*
110000111*
111111000*
<3333333445555555>
