18
161 21 1 90 50 
0.041
**0111100000110
10**01001110001
0000*1001101000
10000*000101001
100100*01101000
111100*01101001
1000000**101000
101111000*01001
001100000*11001
1110011110*1000
10001000001*100
100001001100*10
1111100011000*0
10011001010110*
01100010111111*
<34344454345444445>
