58
7169 915 19 4226 2028 
0.059
*001*1100000110
*00*0*0011*0001
0*0*0*001*0*000
*00*0*000*0*001
*00*0*001*0*000
1**10*00*10*001
10000*000*0*000
101**1001*0*001
00*10000*10*001
1*100***100*000
*000*000000*000
*0000*0011*1111
1****0001*00000
100110010*01111
0110001011*****
<546543211124555556766654333282332218211245555555566543333>
