124
156465 19637 79 64446 72382 
1.123
****10011101**111010111111111101*1111010
1110*001110*01*1101011111111110*0*111010
1110*011000*011*101011111111110*01*11010
11001******10000*01011111011000*011*1010
0011111111111110*1101111111111*10000*010
0000000000000000*11001********111110*010
0101************10010*00000000000000*010
010*00000001111110100*01************1010
010*00**0011100111110*0*0000000111111010
010*0*00*001111101010*0*00**001110011110
0101*0000*00011100000*0*0*00*00111110100
0100001110*0011001110*01*0000*0001110000
0111111111*1000010010*00001110*001100101
0111111111*1011100010*01111111*100001001
011011111*00011111010*01111111*101110001
0111010000*0011111010*0011111*0001111101
0110001010*0010011110*01010000*001111101
01111110101***001000*100001010*001001111
01011111111111******00001110101***001000
0100000000000000011110011111111111******
<333454333332123444556777777777776554223444556454334333332211111111112333333322112444455677777777777655422344455645433433333>
