213
189561 23768 73 105058 60735 
1.222
*********1111111111110111111111111110111
111111111*100000001000111111111110001001
1100111110*010101010101*0000000010101001
1010000000*01010101010*0*111111010101001
10101**100*01000000010*01*11111010101001
1010*00*00*0101***1010*010*0101010101001
1000*00*00*010*000*010*010*0100010101010
1011*001**1010*010*010*0100*111110001010
1010*100000000*010*010*000*0111111111010
1010*001000000*010*010*00*00111010000100
1010*001000000*010*010*0*000111010100100
10111*********1000*010*00*00111010101010
100000000000000000*010*000*0011110101001
10101001**********1000*0100*000000101000
1010100*00000000000000*01010*00000101010
1011100*00001000001000*010000*0000101010
10111001**************01011100*000101010
1011100100000111110111111100000*00101010
10111001000000000111111111100000*0001010
101110000000000000000000000000000*000000
1011101**************************1011110
101110*011111111111111111111111111000010
101110*010010100000000000000000000010010
101110*010010101********1000000000010011
101110*01001000*00000000*0001***00101001
101110*00000000*01010100*00**000*0100101
1010011********100000000*0*01000*0100101
0010010000000000000000001*001000*0100101
11000001111110111101000000001000*0100101
10011111111111111110000101001000*0100101
1001111000011111100*00010100100*01010101
100111111110000010*0*001010000*000010001
100111111111111010*00*0101000*0000000111
100101000010001010*00*010000*00000000100
000101001111001010*00*00000*0000***00100
100101001000001010*001*****0000*000*0100
1000010011111110000*0010100000*00000*000
10000000000000000001*00000000*0000100*00
100111111111111111111********000010010*0
111111011111110000000000000000000000100*
<33333333445555678187655555433333333211112334555555677777777765433333333333332111111111111244454666444444444677777777777777777777777776555543333333212333333345542232334555566666677778118865555444333333322223344444>
