38
234889 29364 3 10526 194999 
1.474
*0000000000000000000
*1000000000000000000
*0111111111111111100
*0111111111111111100
*0111111111111111100
*0111111111111111100
*0111111111111111100
*0111111111111111100
*0111111111111111100
*0111111111111111100
*0111111111111111100
*0111111111111111100
*0111111111111111100
*0111111111111111100
*0111111111111111100
*0111111111111111100
*0111111111111111100
*0111111111111111100
*0000000000000000000
1*******************
<5555555555555555554333333333333333333>
