57
18689 2372 36 8438 7879 
0.141
****10011101**111010
1110*001110*01*11010
1110*011000*011*1010
11001******10000*010
0011111111111110*010
0000000000000000*010
0101************1010
010*0000000111111010
010*00**001110011110
010*0*00*00111110100
0101*0000*0001110000
0100001110*001100101
0111111111*100001001
0111111111*101110001
011011111*0001111101
0111010000*001111101
0110001010*001001111
01111110101***001000
01011111111111*****1
0100000000000000011*
<33345433333212344455677777777777655422344455645433433334>
